........................
........................
.M......MP.....M......M.
.........P..............
.........P..............
.........P..............
......E..........V......
.........P...J..........
.........P..............
.M......MP.....M......M.
.........PPPP...........
........................
........................
.....M......M...........
........................
........................
