........................
M.........M............M
...................P....
........E......V...P....
........PPPPPPP....P....
........P.J.......PP....
........P.........P.....
........P.........P.....
M............M....P....M
..................P.....
..................P.....
...........M............
.....M..................
........................
........................
........................