........................
......M..........M......
........................
.........PPPPPP.........
...M.....P...P..........
.........P.E.P.....P....
.........P...P.....P....
.........P...PP....P....
......J............P.V..
.............PPPPPPP....
.........M......M.......
........................
........M...............
........................
.................M......
........................