........................
......M.............M...
...............PPPPPP...
.....V.........P.E..P...
.............J.P....P...
..................PPP...
........................
...M..........M.........
........................
........................
........M........M......
........................
........................
........................
........................
........................