........................
.....M........PPPP......
..............M.P.......
...............P........
.......M....V.PP........
..........PPPP..........
.................M......
..............M.........
........................
.......J...P............
...M.....P..............
.........E.P............
PPPPPPPPPPPP............
........................
..............M.........
.......................V
